[
  {
    "id": "route-s1f2-1",
    "points": [
      { "x": 140, "y": 190 },
      { "x": 300, "y": 190 },
      { "x": 460, "y": 190 },
      { "x": 620, "y": 190 },
      { "x": 780, "y": 190 },
      { "x": 940, "y": 190 }
    ]
  },
  {
    "id": "route-s1f2-2",
    "points": [
      { "x": 100, "y": 480 },
      { "x": 260, "y": 460 },
      { "x": 420, "y": 450 },
      { "x": 580, "y": 460 },
      { "x": 740, "y": 480 },
      { "x": 900, "y": 490 }
    ]
  }
]
