[
  {
    "id": "route-f1-1",
    "points": [
      { "x": 120, "y": 180 },
      { "x": 280, "y": 180 },
      { "x": 440, "y": 180 },
      { "x": 600, "y": 180 },
      { "x": 760, "y": 180 },
      { "x": 920, "y": 180 },
      { "x": 1080, "y": 180 }
    ]
  },
  {
    "id": "route-f1-2",
    "points": [
      { "x": 80, "y": 500 },
      { "x": 220, "y": 480 },
      { "x": 360, "y": 460 },
      { "x": 500, "y": 450 },
      { "x": 640, "y": 460 },
      { "x": 780, "y": 480 },
      { "x": 920, "y": 500 }
    ]
  },
  {
    "id": "route-f1-3",
    "points": [
      { "x": 150, "y": 320 },
      { "x": 350, "y": 340 },
      { "x": 550, "y": 320 },
      { "x": 750, "y": 340 },
      { "x": 950, "y": 320 }
    ]
  }
]
