[
  {
    "id": "route-s2f2-1",
    "points": [
      { "x": 150, "y": 195 },
      { "x": 310, "y": 195 },
      { "x": 470, "y": 195 },
      { "x": 630, "y": 195 },
      { "x": 790, "y": 195 },
      { "x": 950, "y": 195 }
    ]
  },
  {
    "id": "route-s2f2-2",
    "points": [
      { "x": 110, "y": 470 },
      { "x": 270, "y": 455 },
      { "x": 430, "y": 445 },
      { "x": 590, "y": 455 },
      { "x": 750, "y": 470 }
    ]
  }
]

