[
  {
    "id": "route-s1f3-1",
    "points": [
      { "x": 160, "y": 210 },
      { "x": 320, "y": 210 },
      { "x": 480, "y": 210 },
      { "x": 640, "y": 210 },
      { "x": 800, "y": 210 },
      { "x": 960, "y": 210 }
    ]
  },
  {
    "id": "route-s1f3-2",
    "points": [
      { "x": 120, "y": 460 },
      { "x": 280, "y": 440 },
      { "x": 440, "y": 430 },
      { "x": 600, "y": 440 },
      { "x": 760, "y": 460 }
    ]
  }
]

